NO textures/north.png
SO textures/south.png
WE textures/west.png
EA textures/east.png

F 0,10,200
C 200,200,200

        111011 
       10000001
       1000N001  
       1010101 
      1000001  
     10000001  
     100000001 
     100100001 
      1110011  
       11001   
      110001   
       1100111 
        1000001
        1000001
         11111 
