
F 133,183,157
NO textures/north.png

C 135,206,235

SO textures/south.png
WE textures/west.png


EA textures/east.png

    111111           
   10000001          
   10000001          
   1111001          
    11000011        
     11110001  111  
         1000110001 
         1000011001
         10S0000001 
         1000000001
          10000011  
           11001     
             11

